width: 10
height: 10

terrain:
1 1 1 2 2 1 1 1 1 1
1 3 3 1 1 1 2 2 1 1
1 1 1 1 1 1 1 1 1 1
1 1 1 1 1 1 1 1 1 1
1 1 1 1 1 2 2 1 1 1
1 1 1 1 1 2 2 1 1 1
1 1 1 1 1 1 1 1 1 1
1 1 1 1 1 1 1 1 1 1
1 1 1 1 1 1 1 1 1 1
1 1 1 1 1 1 1 1 1 1

static: (3,3), (3,4), (3,5)

dynamic:
0: (6,6) (6,7)
1: (6,7) (6,8)
2: (6,8) (6,9)
