width: 12
height: 12

terrain:
1 1 1 2 2 1 1 1 1 1 1 1
1 3 3 1 1 1 2 2 1 1 1 1
1 1 1 1 1 1 1 1 1 1 2 1
1 1 1 1 1 3 3 1 1 1 1 1
1 1 1 1 1 3 3 1 1 1 1 1
1 1 2 2 2 1 1 1 2 2 2 1
1 1 1 1 1 1 1 1 1 1 1 1
1 1 1 1 1 1 1 1 1 1 1 1
2 2 2 1 1 1 1 1 1 1 1 1
1 1 1 1 1 1 1 1 1 1 1 1
1 1 1 1 1 1 1 1 1 1 1 1
1 1 1 1 1 1 1 1 1 1 1 1

static: (5,5), (6,5), (5,6), (6,6), (10,10), (11,11)

dynamic:
