width: 8
height: 8

terrain:
1 1 1 2 2 1 1 1
1 3 3 1 1 1 2 2
1 1 1 1 1 1 1 1
1 1 1 1 1 3 3 1
1 1 1 1 1 3 3 1
1 1 2 2 2 1 1 1
1 1 1 1 1 1 1 1
1 1 1 1 1 1 1 1

static: (3,3), (4,3), (3,4), (4,4)

dynamic:
